such as - come/come per esempio
nowadays - oggigiorno
besides - oltre a
seldom - quasi mai
immediately/right away - subito
since - dato che/poichè/da
yet - ancora
meanwhile - intanto/mentre
as well - anche
at least - almeno
instead of - invece di
indeed/as a matter of fact - infatti
almost - quasi
likewise - lo stesso per me
by the way - a proposito
in light of - alla luce di (in light of what happened)
though - però
as though - come se
although/even though/despite - nonostante/anche se
further/furthermore - ulteriormente/più lontano
every now - ogni tanto
rather - piuttosto
rather then - piuttosto che
rather be - preferire essere
rather ill - piuttosto male
and so on - e cosi via
due to - a causa di
whether - se
somehow - in qualche modo
perhaps - forse
nearly - quasi
afterwards - in seguito
thick - spesso
as usual - come sempre (non as always) 
after a while - dopo un pò
whatever - qualunque cosa
suddenly - improvvisamente
all of a sudden - all'improvviso
pretty - piuttosto/carino
anyhow - in ogni caso/senza cura
lately - recentemente
beyond - oltre
above - al di sopra
likely - probabile
early - presto/in anticipo
through - attraverso/durante tutto/a causa di
even - perfino/addrittura/anche
delighted - contentissimo
charming - affascinante
shame - vergongna
shy - timido
wily - furbo/astuto
dull - noioso
funny/hilarious - divertente
gloomy - depresso/cupo
bother - dare fastidio/annoiare
brave/daring - coraggioso
shaggy - disordinato/spettinato
whiskery - bizarro
astonishing - sorprendente
nasty - disgustoso
worth - valido/apprezzabile
amazement - meraviglia
gleeful/cheerful - gioioso/allegro
slight - debole
keen - entusiasta
glad/pleased - contento
creepy - orrendo/pauroso
tricky - complicato/difficile
silly - ridicolo/sciocco
eagerly - impazientemente
proud - fiero
naughty - cattivo/dispettoso
freaky - assurdo/insolito
plump - grassottello
polite - educato/attento
stern - severo
dumbfounded/dazed - meravigliato/confuso
bewitched - affascinato/stregato
bissfully - gioiosamente/beatamente
tasty - attraente
frighten/scare - spaventato
upset - turbato
terrific - estremamente bene
outstanding - eccezionale
miffed - offeso
figure out - capire/risolvere
find out - scoprire
chill out - rilassarsi
freak out - dare di matto
feel like + vrb ing - avere voglia di
look forward to + vrb ing - non vedere l'ora di fare qualcosa
in favor of - a favore di
hurry up - sbrigati
dud - fallimento/"sòla"
badass - cazzuto
weird/weirdo - tipo strano
it works like a charm - lavora da meraviglia
dork - stupido
gotcha (got it) - ti ho beccato/capito
bud/buddy/cuz - amico
dude - tipo/tizio
mate - compagno/socio
nap/snooze - sonnellino (I took a nap)
wonder - chissà/chiedersi
earn - guadagnare
argue - discutere
whacked/knackered - stanco morto
folk - gente
swear - giurare
crackpot/nutty - essere folle/svitato
fool - scemo/ingannare
mind - dispiacersi
geez/blimey/crikey - omg/caspita/accidenti
run by - gestito da
cheers - grazie/arrivederci/evviva
fancy - costoso/voglio (I fancy a drink/do you fancy a drink?)
spot on - accurata/precisa
you crack me up - mi hai fatto ridere
dire/awful - (daya) estremo serio/terribile (that's dire)
top up - ricaricare (soldi sulla carte o telefono ad esempio)
slip off - togliersi/sfilarsi
cheer up - forza!/su di morale!
duffer - incapace
watch it! - attento (attento a quello che dici!)
crap - schifezza
deal - affare
stuff - cose
no way! - nemmeno per sogno/impossibile/non ci credo
no matter what - non importa cosa
spot - posto/punto
lift - passaggio con la macchina (give me a lift)
rubbish - spazzatura (don't talk rubbish - non dire stupidaggini)
barking - fuori di testa
hang on - aspettare/attendere
dare - osare
dumb - stupido
maggot - verme
beware - fare attenzione
like this - in questo modo
rent - noleggiare
grief/pain - dolore
rest - pausa/riposo
proud - orgoglioso/fiero
trouble - difficoltà
wary - sospettoso/diffidente
smell - odore/puzza
blame - incolpare/biasimare
forgive - perdonare
afford/allow - permettersi
disappoint - deludere
complain/groan/moan - lamentarsi/protestare
deserve - meritarsi
tears - lacrime
chill - freddo
borrow - prendere in prestito
lend - prestare
outfit - completo (vestito)
locker - armadietto
days off - giorni liberi
go off - andare via
overslept - dormire troppo
fave (favourite) - preferito
lack - mancanza
purpose - scopo 
agreement - accordo
sluggish - lento/fiacco
slaughter - massacro
in shape - in forma
masterpiece - capolavoro
chase - inseguire/cacciare
take care - prendersi cura
begging - supplicare
sick - male (I feel sick)/vomitare
reach - raggiungere
reach out - mettersi in comunicazione (thanks for reaching out to us)
dwell - risiedere
content - contenuto/soddisfatto
shied away - allontanarsi
accomplished/master - esperto
master - maestro/padroneggiare
might - forza/potere(may)
beefy - muscoloso
bear - sopportare
shudder/tremble/gasp/quiver/shiver - tremare
briefcase - valigetta
peck - baciare velocemente
jerk - idiota/sobbalzare
blink - lampeggiare/sbattere palpebre
stare/gaze/gawp - fissare
jam - ingorgo/traffico/marmellata
cloak - mantello
wheel - ruota
steering weel - volante
whisper - bisbigliare
enrage - infuriare
stunt - caduta/acrobazia
yell/shout/howl/shriek - gridare
clutch - stringere forte
snap - spezzarsi/aggredire
eager - avido/entusiasta
seize - afferrare
rejoice - gioire
hug - abbracciare
rattle - innervosire
creep - camminare
slither - strisciare
yawn - sbadigliare
overhead - sopra la testa
swoop - piombare
twitch/fidget - agitarsi
sinking - agitato
spark - scintilla
sparkle/glint/gleam - luccicare
crooked - storto
amuse - divertire
chuckle - ridere sotto i baffi
mutter - borbottare
stiffly - severamente
blush - arrossire
bow - fare un inchino
pull out - tirare fuori
underneath/beneath - sotto
wise - saggio
huge - enorme
blanket - coperta
bent - piegato
duck - piegarsi
gingerly - con attenzione
tidy - ordinato (in ordine)
holding up - sostenere
fateful - grave/disastroso
rap - bussare
skinny - magro
thin - sottile
comb - pettine/pettinarsi
wig - parrucca
leap - balzo
ruin - rovinare
blow up - far esplodere
wail - piangere
relief - sollievo
climb - scalare
chase - cacciare/inseguire
poison - veleno
poisonous - velenoso
crush/squeeze/squash - schiacciare
raise - alzare
wink - fare l'occhiolino
strain/effort/struggle - sforzo
sink - affondare
wet - bagnato
heavy - pesante
slam - sbattere
breath - respiro
sigh - sospirare
strangle - strangolare
wrestle - lottare
tear - lacrima/strappare
mutter - borbottare
snore - russare
damp - umido
shack - baracca
forecast - previsioni
wicked - cattivo
lead/steer - condurre/guidare
splatter - schizzare
hut - rifugio
drown - annegare
crumble - sgretolarsi
crumbling - pericolante
skid - scivolare
rifle - fucile
fierce - feroce
knot - nodo
shrivelled - stropicciato
sunk - sommerso
scribble - scarabocchiare
wisdom - saggezza
crowd - folla
crowded - affollato
crowd in - affollarsi
outrage - oltraggio/sdegno
fade - svanire
gulp - deglutire
deny - negare
warmth - calore umano
heat - calore
wizard/sorcerer - stregone
fear/dread - paura
lame - poco convincente/debole (una battuta ad esempio)
vent - sfogarsi
tight - stretto
loud - rumoroso
tapping - colpo
buzz - ronzio/vibrazione
chatter - chiacchiere
rush - di corsa
surrounding - circostanza
attentive - attento
properly - correttamente
charge - accusa/essere responsabile (in charge of)
downward - verso il basso
railway - ferrovia
whistle - fischiare
savage - selvaggio
glittery - luccicante
swallow - ingoiare
awkwardly - maldestramente
heartstrings - sentimenti
customer - cliente/personaggio
single out - identificare
bite - mordere
willingness - buona volontà
throat - gola
carpet - tappeto
trunk - portabagagli
freckles - lentiggini
nod - cenno col capo	
scrape - graffio
shove - spingere
wave - salutare con la mano/onda
glance - occhiata/guardata
starving - affamato
swap - scambiare
rob - derubare
vault - camera blindata
echo - eco
smooth - liscio
blessing - benedizione
affect - influisce/riguardano
praise - elogiare 
pollution - inquinamento
narrow - stretto/restringere
loose - largo/lento (pantaloni)
reliable - affidabile
succeed - trionfare
harm - fare del male
linger - soffermare
greasy - unto
out of bound - proibito
sweating - sudore
wander - passeggiare
swollen - gonfio
stand - alzarsi/schierarsi/sopportare
pour - versare
alike - simile
bury - coprire/seppellire
lazy - pigro
shattering - sconvolgente/distruzione
wounded - ferito
injury - ferita
facility - struttura/capacità
hire - assumere(lavoro)
fine - multa
envy - invidia
own - possedere/proprio
tradeoff - compromesso
get on with sb - andare d'accordo con
sum up - riassumere
as - come/poiché/mentre
as for - per quanto riguarda
boast about - vantarsi di
aware of - consapevole di
provide by - forniti da
hint - suggerimento
manage to - riuscire a
take a look at - dai uno sguardo a
by and by - tra poco/ a breve
get around to sth - trovare tempo per
as soon as - non appena
catch up with sb - raggiungere qualcuno
carry out - mettere in pratica/compiere
give in to sb - arrendersi a qualcuno
put off - rimandare
go by - passare (tempo e movimento)
easy going - tipo alla mano
carry off - sequestrare/rapire
hand in - presentare/consegnare
go on doing - continuare
get rid of sth - disfarsi di qualcosa
get on - salire/andare d'accordo/continuare
acknowledge sb for - apprezzare qualcuno per qualcosa
call on sb - andare a trovare/rivolgersi
thus - perciò/quindi
overall - generale/globale
for god's sake - per l'amore del cielo
set off from - andare via da
all in all - tutto sommato
drawback - svantaggio
turn out to be - rivelarsi
complaint - protesta
stabbed - pugnalato
tough - duro/difficile
in regard to - riguardo a
foresee - prevedere
on fire - andare alla grande/essere a mille
go off - esplodere
used to vb - fare sempre qualcosa/una volta lo facevo
look after - prendersi cura
end up - finire
cosy - comodo/confortevole
excruciating - straziante
but - tranne/eccetto
moron - imbecille/deficiente
save it - risparmialo
willigness to vb - buona volontà
outstanding - eccezionale
pull out - togliere/rimuovere
run out of sth - terminare
quite - abbastanza
look up to - ammirare
awkward - arduo/difficile
not really - non proprio
there you are - eccoti (ti ho trovato)
here is your sth - ecco il tuo qualcosa
here you are - ecco a te
tell - notare
it's up to you to - sta a te/tocca a te
owe - avere un debito
keep off - stare alla larga
cocksucker - testa di cazzo
murder - omicidio
bats - fuori di testa
business - questione/faccenda
kiddo - bambino/a
how's it going? - come va?
it's going great - sta andando alla grande
doing well/great - sta andando bene/alla grande
kinda tired - un po stanco
shitbrick - pezzo di merda
pumpkin/darling/sweetheart/honey - tesoro/amore
hold - attendere
ain't - non essere
outburst - scoppiare emotivamente
root - fare il tifo
out there - là fuori
such a big deal - così importante
actually - davvero
uncomfortable - a disagio/spiacevole
above all - soprattutto
fairness - correttezza/onestà
addicted - dipendente/preso da
harmfull - dannoso/pericoloso
unwilling to do - non intenzionato a
involve - comportare/implicare
sympathy - compassione/affetto
guilty - colpevole
check it out - guarda
toss - gettare via
guest - ospite
host - padrone di casa/ospitare
at will - a piacere
copy that - ricevuto

